space=" "
comment_block_left="/*"
comment_block_right="*/"
comment_line="%"
lparen="("
rparen=")"
lsquare="["
rsquare="]"
double_quote="\""
single_quote="'"
positive_sign="+"
negative_sign="-"
dot="."
comma=","
colon=":"
exponent="E"
vline="|"
slash="/"
zero="0"
nonzero="1"
lower_alpha="a"
upper_alpha="A"
dollar="$"
cnf="cnf"
fof="fof"
include="include"
axiom="axiom"
forall="!"
exists="?"
not="~"
and="&"
equal="="
not_equal="!="
biimplication="<=>"
implication="=>"
back_implication="<="
not_biimplication="<~>"
not_or="~|"
not_and="~&"
